1111111111111
10010000000C1
1000011111001
110011000P001
1111111111111
