1111111111111
100000E0000M1
1000CCCCC0001
1000CCCCC0001
1000CCCCC0001
1000CCCCC0001
1000CCCCC0001
1000CCCCC0001
1000CCCCC0001
1000CCCCC0001
1P00000000001
1111111111111