1111111111111
10010P00000C1
1000011111001
1P0011000E001
1111111111111
