1111111111111
10010000000C1
100001111111
1P0011000E001
1111111111111
